#######
#@..#1#
#..#..#
#.....#
#######
