########
#@.....#
#......#
#....1.#
#.....2#
########
