#######
#@....#
#.....#
#....1#
#######
