#####
#@..#
#...#
#..1#
#####
