########
#@..#..#
#..#...#
#.....1#
#....2.#
########
